0 4 0 0 0 0 0 1 1 0 1 1 0 0 0 0 0 0 0 0 0 0 0
0 4 1 1 1 1 0 1 0 1 0 1 0 0 0 4 0 0 4 4 4 4 0
0 1 2 2 2 1 4 1 1 0 1 1 0 0 1 0 0 0 0 0 0 4 0
0 4 3 3 2 1 0 1 0 1 0 1 0 0 1 0 0 0 0 0 0 4 0
0 0 0 3 2 1 4 1 1 0 1 1 0 0 1 0 0 0 0 0 0 4 0
0 4 3 3 2 1 0 1 0 1 0 1 0 0 1 0 0 0 0 0 0 4 0
0 4 2 2 2 1 0 1 1 0 1 1 0 0 1 0 0 0 0 0 0 4 0
0 4 1 1 1 1 0 1 0 1 0 1 0 0 1 0 0 1 0 0 0 4 0
0 1 0 0 0 0 4 1 1 0 1 1 0 0 0 0 0 1 0 0 0 4 0
0 4 0 0 0 1 0 1 0 1 0 1 0 0 0 0 0 1 0 0 0 4 0
0 4 0 0 1 0 0 1 1 0 1 1 0 0 0 0 0 1 0 0 0 4 0
0 4 0 1 0 0 4 1 0 1 0 1 0 0 0 0 0 1 0 0 0 4 0
0 1 0 1 0 0 0 1 1 0 1 1 0 0 0 0 0 1 0 0 0 4 0
0 4 0 0 1 0 0 1 0 1 0 1 0 0 0 0 0 1 0 0 0 4 0
0 4 0 0 0 1 4 1 1 0 1 1 0 0 0 0 0 1 0 0 0 4 0
0 4 0 0 0 1 0 1 0 1 0 1 0 0 0 1 0 0 0 0 0 4 0
0 1 0 0 1 0 0 1 1 0 1 1 0 0 0 1 0 0 0 0 0 4 0
0 4 0 0 0 1 0 1 0 1 0 1 0 0 0 1 0 0 0 0 0 4 0
0 1 0 0 0 1 4 1 1 0 1 1 0 0 0 1 0 0 0 0 0 4 0
0 4 4 4 0 1 0 1 0 1 0 1 0 0 0 1 0 0 0 0 0 4 0
0 0 0 4 0 1 0 1 1 0 1 1 0 0 0 0 0 0 0 0 0 4 0
0 4 0 4 0 0 4 1 0 1 0 1 0 0 0 4 0 0 4 4 4 4 0
0 0 0 4 0 0 0 1 1 0 1 1 0 0 0 0 0 0 0 0 0 0 0
3